####################
#@   $   X    .    #
#        X         #
#        X         #
#      L CX        #
#        X         #
#                  #
####################
