###########
#.  $   P    #
#.  $     #
#   $  . P #
#  @      #
###########
