####################
#@        X    .   #
# $HHH P  X        #
#  H F H. X        #
#  HHH    X        #
#         X        #
#         XC  L    #
#         X        #
#         X   P    #
#         X        #
####################
