####################
#@     $     .     #
#                  #
#   F .    HHH     #
#          H H     #
#     $      .     #
#                  #
####################
