####################
#@        X    .   #
# $HHH P  X        #
#  H F H. X   Y    #
#  HHH    X        #
#    U    X        #
#         XC  L    #
#         X        #
#         X   P    #
#         X        #
####################
