##################################
#......#####                    .#
#.......####   $ $ $           . #
#$       ###                     #
#         ##                     #
# ##      ##   $ $ $$$     P     #
#                                #
# $$ ###           #      @      #
#                $ #$ $          #
#        P         #             #
#                  #           ..#
##################################